g g r g g w w w w w g g g g t t r d d g g g r g t t t t t t g t g g t r t t t t g g g g w w w w w w
t g g g g g w w w w w t g g g g g d d t r g g g g g t t t t t t t t t t t g t t g g w w w w w w w w
g g g g g g w w w w w t g g g g g d d t r g g g g g t t t t t t t t t t t g t t g g w w w w w w w w
g g g g g g g g g g g g g g g g g d d g g g g g g g g g g g g g g g g g g g g g g g g w w w w w w w
g g g g g g g g g g g g g g g g g d d g g g g g g g g g g g g g g g g g g g g g w w w w w w w w w w
g g g g g g g g g g g g g g g g g d d g g g g g g g g g g g g g g g g g g g w w w w w w w w w w w w
g g g g g g g g g g g g g g g g g d d g g g g g g g g g g g g g g g g g g g w w w w w w w w w w w w
g g g g g g g g g g g g g g g g g d d g g g g g g g g g g g g g g g g g g g g g g g w w w w w w w w
g g g g g g g g g g g g g g g g g d d g g g g g g g g g g g g g g g g g g g g g g g w w w w w w w w
g g g g g g g g g g g g g g g g g d d g g g g g g g g g g g g g g g g g g g g g g g g g g g g g g g
g g g g g g g g g g g g g g g g g d d g g g g g g g g g g g g g g g g g g g g g g g g g g g g g g g
g g g g g g g g g g g g g g g g g d d g g g g g g g g g g g g g g g g g g g g g g g g g g g g g g g
g g g g g g g g g g g g g g g g g d d g g g g g g g g g g g g g g g g g g g g g g g g g g g g g g g
g g g g g g g g g g g g g g g g g d d g g g g g g g g g g g g g g g g g g g g g g g g g g g g g g g
g g g g g g g g g g g r g g g g g d d g g g g t g g g g g g g g g g g g g g g g g g g g g g g g g g
g g g g g g g g g g g g g g g g g d d g g g g g g g g g g g g g g g g g g g g g g g g t g g g g g g
g g g g g g g g g g g g g g g g g d d g g g g g r r g g g g g g g g g g g g g g g g g g g g g g g g
g g g g g g g g g g g g g g g g g d d g g g g g g g g g g g g g g g g g g g g g g g g g g g g g g g
g g g g g g g g g g g g g g g g g d d g g g g g g g g g t g g g g g g g g g g g g g g g g g g g g g
g g g g g g g g g g r g g g g g g d d g g g g g g g g g g g g g g g g g g g g g g g g g g g g g g g
g g g g g g g g g g g g g g g g g d d g g g g g g g g g g g g g g g g g g g g g g g g g g g g g g g
g g g g g g g g g g g g g g g g g d d g g g g g g g g g g g g g g g g g g g g g g g g g g g g g g g
g g g g g g g g g g g g g g g g g d d g g g g g g g g g g g g g g g g g g g g g g g g g g g g g g g
g g g g g g g g g g g g g g g g g d d g g g g g g g g g g g g g g g g g g g g g g g g g g g g g g g
g g g g g t g g g g g g g g g g g d d g g g g g g g g g g g g g g g g g g g g g g g g g g g g g g g
g g g g g g g g g g g g g g g g g d d d d d d d d d d d d d d d d d d d d d d d d d d d d d d d d d
g g g g g g g g g g g g g g g g g d d d d d d d d d d d d d d d d d d d d d d d d d d d d d d d d d
g g g g g g t g g g g g g g g g g d d g g g g g g g g g g g g g g g g g g g g g g g g g g g g g g g
g g g g g g g g g g g g g g g g g d d g g g g g g g g g g g g g g g g g g g g g g g g g g g g g g g
g g g g g g g g g g g g g g g g g d d g g g g g g g g g g g g g g g g g g g g g g g g g r g g g g g
g g g g g g g g g g g g g g g g g d d g g g g g g g g g g g g g g g g g g g g g g g g g g g g g g g
g g g g g g g g g g g g g g g g g d d g g g g g g g g g g g g g g g g g r g g g g g g g g g g g g g
g g g g g g g g g g g g g g g g g d d g g g g g g g g g g g g g g g g g g g g g g g g g g g g g g g
g g g g g g g g g g g g g g g g g d d g g g g g g g g g g g g g g g g g g g g g g g g g g g g g g g
g g g g g g g g g g g g g g g g g d d g g g g g g g g g g g g g g g g g g g g g g g g g g g g g g g
g g g g g g g g g g g g g g g g g d d g g g g g g g g g g g g g g g g g g g g g g g g g g g g g g g
g g g g g g g g g g g g g g g g g d d g g g g g g g g g g g g g g g w w g g g g g g g g g g g g g g
g g g g g g g g g g g g g g g g g d d g g g g g g g g g g g g w w w w w w w g g g g g g g g g g g g
g g g g g g g g g g g g t g g g g d d g g g g g g g g g g g g w w w w w w w g g g g g g g g g g g g
g g g g g g g g g g g g g g g g g d d g g g g g g g g g g g g w w w w w w g g g g g g g g g g g g g
g g g g g g g g g g g g g g g g g d d g g g t g g g g g g g g w w w w w w g g g g g g g g g g g g g
g g g g g g g g g g g g g g g g g d d g g g g g g g g g g g g g g g g g g g g g g g g g g g g g g g
g g g g g g g g g g g g g g g g g d d g g g g g g g g g g g g g g g g g g g g g g g g g g g g g g g
g g g g g g g g g g g g g g g g g d d g g g g g g g g g g g g g g g g g g g g g g g g g g g g g g g
g g g g g g g g g g g g g g g g g d d g g g g g g g g g g g g g g g g g g g g g g g g g g g g g g g
g g g g g g g g g g g g g g g g g d d g g g g g g g g g g g g g g g g g g g g g g g g g g g g g g g
g g g g g g g g g g g g g g g g g d d g g g g g g g g g g g g g g g g g g g g g g g g g g g g g g g
g g g g g g g g g g g g g g g g g d d g g g g g g g g g g g g g g g g g g g g g g g g g g g g g g g
g g g g g g g g g g g g g g g g g d d g g g g g g g g g g g g g g g g g g g g g g g g g g g g g g g
g g g g g g g g g g g g g g g g g d d g g g g g g g g g g g g g g g g g g g g g g g g g g g g g g g