0 2 0 0 4 5 0 0 0 0 0 0 0 0 0 2
2 1 0 0 4 3 3 0 0 0 0 0 0 1 0 1
0 0 1 0 0 4 5 4 3 0 0 0 0 0 0 1
1 0 2 0 0 3 4 5 4 0 0 0 0 2 0 0
0 0 0 0 0 0 0 3 4 0 0 0 0 0 0 0
0 0 0 0 0 0 0 0 5 0 0 0 1 0 0 0
0 0 0 0 0 0 0 0 2 0 0 0 0 0 2 0
0 0 0 0 0 0 0 0 0 0 0 2 0 1 0 0
0 0 0 0 0 0 1 1 0 1 0 0 0 0 0 0
0 0 1 1 1 2 0 2 0 0 0 0 2 3 4 4
0 2 0 0 0 0 0 2 0 0 0 0 5 3 5 4
1 0 0 0 0 0 0 0 1 1 0 0 4 3 3 3